1111111111111111111111111111111111
1P0E00000000000C00000C000000000001
1010010100100000101001000E00010101
1010010010101010001001000000010101
100000000C00C00000000000000E0000C1
1111111111111111111111111111111111