11111111111111111111111111111111111111111111111
11111110000000000001000000000000000000000000001
1000000C000000000001000000000000000000000001111
10000001000000P00001000000000000000000000000001
10010010010000000000000000E00000000000000000111
10010010010000C000010000C0000000000000000000001
100100100100000C0001000000000000000000000100001
10010010010000000000000000000000000000000000101
10010010010000C000010000C0000000000000000000001
100100100100000C0001000000000000000000000100001
10010010010000000000000000000000000000000000101
10010010010000C000010000C0000000000000000000001
100100100100000C0001000000000000000000000100001
10010010010000000000000000000000000000000000101
10010010010000C000010000C0000000000000000000001
100100100100000C0001000000000000000000000100001
10010010010000000000000000000000000000000000101
11111111111111111111111111111111111111111111111