1111111111111111111111111111111111
1P0E000000000000000000000000000001
1010010100100000101001000000010101
1010010010101010001001000000010101
100000000000000CCC0000000000000000
1111111111111111111111111111111111