1111111111111111111111111111111111
1000000000000000000000000000000001
1010010100100000E01001000000010101
1010010010101010001001000000010101
100000000P00C000000000000000000001
1111111111111111111111111111111111